+-+-+-+-+-+-+-+-+-+-+-+-+-+-+-+-+
|                               |
+ +-+-+-+-+-+-+-+-+-+-+-+-+-+-+ +
| |   |   |                     |
+ + + + + + +-+-+-+-+-+-+ +-+ + +
|   |   |   | |   |   |   |   | |
+ + +-+-+-+ + + + + + + +-+ +-+ +
| |       | |   |   |   |   | | |
+ +-+-+-+ + + + + + + +-+ +-+ + +
|     |   | | |   |   |   |   | |
+-+-+ + +-+ + +-+-+-+-+ +-+ + + +
|   | |   | |   |     |     | | |
+ + + +-+ + + + + +-+ +-+-+-+ + +
| | |   | | | |   |       | | | |
+ + + +-+ + +-+-+-+ +-+-+ + + + +
| |   |   | | |   |       | | | |
+ + +-+ +-+ + + + + +-+ + + + + +
| | |   | | |     | |   | | | | |
+ +-+ +-+ + + +-+-+-+ +-+ + + + +
|     |   | |           | | | | |
+-+ +-+ + + + +-+-+-+-+ + + + + +
|     | | | |             |   | |
+-+ +-+ + + +-+-+-+-+-+-+ +-+ + +
|     | | |             | |   | |
+-+ +-+ + + +-+-+-+-+ + +-+ +-+ +
|     | | | |     |   |   |   | |
+-+ +-+ + +-+ +-+ + + + + +-+ + +
|       |       |   |   |   | | |
+ +-+-+-+-+ +-+ +-+-+-+ +-+ + + +
|   |   |   |               | | |
+ + + + + + +-+-+-+-+-+ +-+ + + +
| |   |   |                 |   |
.-+-+-+-+-+-+-+-+-+-+-+-+-+-+-+-+
